4	  3	  3	  0	  0	  0	  0	  0
5	  -3	-3	0	  0	  0	  0	  0
6	  6	  -5	0	  0	  0	  0	  0
2 	-5 	-5 	0 	1 	1 	3.1 1
1 	10 	10 	0 	2 	10 	15 	0
0   0   0   0   0   0   0   0
