
1	9	6.5	0	2	12	10	0
1	-5	0	0	10	2	10	0
1	-10	0	0	2	18	10	0

2 	17 	8 	0 	1 	1 	3.1 	1
2 	5 	-9 	0 	1 	1 	3.1 	1

4	15	11	0	0	0	0	0

6	-3	-6	0	0	0	0	0
6	-7	-5	0	0	0	0	0

7	-4	8	0	0	0	0	0
7	-7	7	0	0	0	0	0

5	12	-9	0	0	0	0	0
5	-17	0	0	0	0	0	0
8	15	12.5	0	2.5	0.5	5	0

9	-20	0	0	0.5	2.5	5	0

0 0 0 0 0 0 0 0



6	-3	-6	0	0	0	0	0
6	-7	-5	0	0	0	0	0

7	-4	8	0	0	0	0	0
7	-7	7	0	0	0	0	0

5	12	-9	0	0	0	0	0
5	-17	0	0	0	0	0	0