1	9	-7	0	22	2	10	0
1	-9	7	0	22	2	10	0

3	-6	-4	0	8	8	0	0

5	-16	10	0	0	0	0	0
5	-13	9	0	0	0	0	0
5	-15	-5	0	0	0	0	0

6	5	5	0	0	0	0	0

7	6	0	0	0	0	0	0
7	14	-10	0	0	0	0	0

4	19	0	0	0	0	0	0
8	20	0	0	0.5	2.5	5	0
9	16	-12.5	0	2.5	0.5	5	0
0	0	0	0	0	0	0	0