1	-16	8	0	3	3	10	0
1	-16	-8	0	3	3	10	0
1	0	0	0	3	3	10	0
1	16	8	0	3	3	10	0
1	16	-8	0	3	3	10	0

5	-11	-8	0	0	0	0	0
5	11	8	0	0	0	0	0
5	1	-9	0	0	0	0	0
5	1	9	0	0	0	0	0

7	-18.25	8	0	0	0	0	0
7	18.25	-8	0	0	0	0	0

4	-19	0	0	0	0	0	0
8	-20	0	0	0.5	2.5	5	0
9	20	0	0	0.5	2.5	5	0
0	0	0	0	0	0	0	0