1	5	0	0	2	15	10	0
1	-14	-8	0	12	2	10	0


3	-10	4	0	10	10	0	0


5	15	-7	0	0	0	0	0
5	-17	9	0	0	0	0	0

6	17	6	0	0	0	0	0
6	0	-3	0	0	0	0	0

7	-18	-10	0	0	0	0	0

4	16	11	0	0	0	0	0
8	16	12.5	0	2.5	0.5	5	0
9	-16	-12.5	0	2.5	0.5	5	0
0	0	0	0	0	0	0	0