1	7	6	0	15	2	15	0
4	3	3	0	0	0	0	0
5	-3	-3	0	0	0	0	0
6	5	-7	0	0	0	0	0
7 	0 	0 	0 	1 	1 	3.1 	1
2 	-8 	8 	0 	1 	1 	3.1 	1
1 	10 	10 	0 	2 	10 	15 	0
8	-20	-10	0	0.5	2.5	5	0
9	15	-15	0	2.5	0.5	5	0
0 0 0 0 0 0 0 0