2 	12 	5 	0 	1 	1 	3.1 	1
2 	12 	-5 	0 	1 	1 	3.1 	1
2 	-12 	-1 	0 	1 	1 	3.1 	1
2 	-10 	1 	0 	1 	1 	3.1 	1
2 	-8 	0 	0 	1 	1 	3.1 	1

3	-10 	7 	0 	4 	11 	0 	0
3	-10	-7 	0 	4 	11 	0 	0

4	15	11	0	0	0	0	0

6	9	5	0	0	0	0	0
6	10	0	0	0	0	0	0
6	9	-5	0	0	0	0	0

7	12	0	0	0	0	0	0

5	-17	-10	0	0	0	0	0
5	-17	10	0	0	0	0	0

8	20	0	0	0.5	2.5	5	0

9	-20	0	0	0.5	2.5	5	0

0 0 0 0 0 0 0 0


