12	0	0	0	0	0	0	0
4	-19	10	0	0	0	0	0

8	-20	10	0	0.5	2.5	5	0

9	15	-12.5	0	2.5	0.5	5	0

10	-12	-10	0	0	0	0	0
10	-9	-10	0	0	0	0	1
10	-6	-10	0	0	0	0	2
10	-3	-10	0	0	0	0	3
10	0	-10	0	0	0	0	4
0	0	0	0	0	0	0	0



1	0	6.5	0	2	12	10	0

2 	3 	-2 	0 	1 	1 	3.1 	1
2 	-12 	-10 	0 	1 	1 	3.1 	1
2 	-8 	-10 	0 	1 	1 	3.1 	1

3 	-6 	0 	0 	7 	7 	0 	0
6	-10	10	0	0	0	0	0
6	-2	-8	0	0	0	0	0

5	15	5	0	0	0	0	0
5	13	7	0	0	0	0	0
